10
01n 01n
01n 01n
10n
01n 02n 02n
03n 01n
01n 01n 01n
03n 01n
04n 02n
10n
01n 01n
;
07n
01n 01n 04n
01n 07n
02n 02n
01n 01n
01n 01n
02n 01n
01n 01n 01n
02n 03n
07n
;
0 0 1 0 0 0 0 1 0 0
0 0 0 1 0 0 1 0 0 0
1 1 1 1 1 1 1 1 1 1
1 0 1 1 0 0 0 0 1 1
1 1 1 0 0 0 0 0 0 1
1 0 1 0 0 0 0 0 0 1
1 1 1 0 0 0 0 0 0 1
1 1 1 1 0 0 0 0 1 1
1 1 1 1 1 1 1 1 1 1
0 1 0 0 0 0 0 0 1 0