15
10n 02n
09n 01n
09n 04n
09n 05n
02n 05n 04n
01n 01n 02n 04n
02n 02n 02n 03n
02n 01n 02n 02n 02n
03n 02n 01n 02n 01n
03n 02n 01n 01n 01n
03n 02n 01n 01n 01n
02n 02n 01n 01n 01n
01n 01n 01n
02n 02n
15n
;
04n 06n 03n
05n 06n 02n
05n 04n 01n
04n 01n 01n 01n
04n 01n 01n 01n 01n
05n 01n 01n 01n 01n
05n 01n 01n 01n 01n
05n 01n 01n 01n 01n
06n 01n 01n 01n
01n 04n 01n 01n 01n
01n 03n 01n
04n 01n 01n
05n 04n 01n
01n 06n 02n
15n
;
1 1 1 1 1 1 1 1 1 1 0 0 0 1 1
1 1 1 1 1 1 1 1 1 0 0 0 0 0 1
1 1 1 1 1 1 1 1 1 0 0 1 1 1 1
1 1 1 1 1 1 1 1 1 0 1 1 1 1 1
0 1 1 0 0 1 1 1 1 1 0 1 1 1 1
1 0 0 1 0 0 0 0 1 1 0 1 1 1 1
1 1 0 0 1 1 0 0 0 1 1 0 1 1 1
1 1 0 1 0 0 1 1 0 1 1 0 0 1 1
1 1 1 0 1 1 0 0 1 0 1 1 0 0 1
1 1 1 0 0 0 1 1 0 1 0 0 1 0 1
1 1 1 0 1 1 0 0 1 0 0 0 1 0 1
0 1 1 0 0 0 1 1 0 1 0 0 1 0 1
1 0 0 0 0 0 0 0 0 0 0 0 1 0 1
1 1 0 0 0 0 0 0 0 0 0 0 0 1 1
1 1 1 1 1 1 1 1 1 1 1 1 1 1 1